11111111111111111111
10000000000000000001
10000000000000000001
1000000000000C000001
1000000001P100000001
100000E0001000000001
10000000000000000001
11111111111111111111