1111111111111111111111111111111111
110010000000000C00000C000000000001
10101101001000001010010000C0010101
1010100010101010001001001000010101
100000000C00C0000C00000100CC0000C1
1P10010010101010001001000000010101
1010010010101000100100011100010101
101001001010101000100100CC0001C101
110010000000000C00000C000000000001
10101101001000001010010000C0010101
1010100010101010001001001000010101
1000000C0C00C0000C00000100CC0000C1
1010010011101010001001000000010101
101001001E101000100100011100010101
101001001010101000100100CC0001C101
100010000000000C00000C000000000001
10101101001000001010010000C0010101
1010100010101010001001001000010101
101001001010101000100100CC0001C101
1111111111111111111111111111111111